1111111111
1P00001111
1111111111
1111111C01
111111E101
1111111111
