11111111111
10000000001
10C00C00001
00000P00000
10000000E01
11111111111
