11111111111
10000000001
10C00C00001
10000P00001
10000000E01
1111111111
