11111111111
10000000001
10000000001
10000P00001
10000000E01
11111111111
