11111111111
10000000001
10C11C00001
10001P00001
10001000E01
11111111111
