111111111111111111111111111111111111111111
100000000000000C000000000000000000000000E1
101001010010000010100100000001010100000001
101001001010101000100100000001010100000001
100000000000000000000000000000000000000001
100000000C00C000000000000000000000000C0001
101001010010000010100100000001010100000001
100000000000000000000000000000000000000001
100000000C00C000000000000000000000000C0001
100000000000000000000000000000000000000001
1P0000000000000000000000000000000000000001
111111111111111111111111111111111111111111
